9 10
1011110111
1110111011
1110110101
0010100001
1110111010
1011110100
1000010001
1011110111
1110001001
