9 10
.@....@...
...@...@..
...@..@.@.
@@.@.@@@@.
...@...@.@
.@....@.@@
.@@@@.@@@.
.@....@...
...@@@.@@.
